#####
#S  #
# # #
#   #
#####
E

