###############
#    #    #  #
# ## # ## #  #
# ## # ## #  #
#S   #    #  #
###############
