###############
#    #    #  #
# ## # ## #  #
# ## # ## #  #
#S   #  E #  #
###############
