#####
#S  #
#   #
#   #
#####
E
